**********
*        *
* * ******
* *      *
* ** * ***
* *  * * *
* *      *
* ** * ***
* *      *
**********